000000000000000000000000000000
000000000000222200000000000000
000000000000000000000000000000
022200000000000000000000022220
000000000000000000000000000000
000000000000000000000000000000
000000000000000000000000000000
000000022222000000000000000220
000000000000000000000000000000
000000000000000000000000000000
220000000000000002200000022000
112222222222222221100002211200
111111111111111111100001111100
000000000000000000000010111000
000000000000000000000000100000
000000000000000000000101000000
000000000000000000000000000000
